xxxxxxxxxxxxxxxxxxxxxxxxxxxxxx
xxxxxx00000000000000000000000x
x0500000xxx0xxxxxxx0xxx005000x
x0x0x0x0xxx0000x0000xxx0xx0x0x
x0x0x0x0000xxx0x0xxx0500xx0x0x
x0x0x0xxxx0xx45x04xx0xxxxx0x0x
x0x0x0x0000xxx0x0xxx0000xx0x0x
x0000000500000000000000000000x
x000500040xxx0440xxx040000000x
xxxxxxx040x04444440x040xxxxxxx
xxxxxxx040x04444440x040xxxxxxx
xxxxxxx040x04444440x040xxxxxxx
x000000040x00000000x000000000x
x0xxxxxxx0xxxxxxxxxx0xxxxxxx0x
x0000000400005000000000000000x
x0xxxx0x00xxxxxxxxx00x0xxxx00x
x000xx0x000050x000000x0xx0005x
x0x0xx0x00xxx0x0xxx00x0xx0xx0x
x5x0xx000xxx00x00xxx0x0xx0xx0x
x0000000000000000005000000000x
xxxxxxxxxxxxxxxxxxxxxxxxxxxxxx